0000000000000000
0   1          2
0   1    0     2
0   1    0     2
0   1    0     2
0   1    0     2
0   1    0     2
0              2
0   13  32     2
0   13  32     2
0   13  32     2
0   13  32     2
0   133332     2
0   122222     2
0              2
0000222222222222
