111111111111111111111111
1                      1
1                      1
1                      1
1     22222    3 3 3   1
1     2   2            1
1     2   2    3   3   1
1     2   2            1
1     22 22    3 3 3   1
1                      1
1                      1
1                      1
1                      1
1                      1
1                      1
1                      1
133333333              1
13 3    3              1
13    0 3              1
13 3    3              1
13 333333              1
13                     1
133333333              1
111111111111111111111111